######~~~~##############
####~~~~~###############
#####~~~~###########~~##
####~~~~~~~#######~~~~##
##################~~~~~#
####################~~##
##~~~~~#################
###~~~~#################
########################